"filename", "language", "TypeScript", "comment", "blank", "total"
"d:\typescript\learning\c5-ts-fp\src\Box.ts", "TypeScript", 6, 0, 1, 7
"d:\typescript\learning\c5-ts-fp\src\Maybe.ts", "TypeScript", 15, 0, 3, 18
"d:\typescript\learning\c5-ts-fp\src\Queue.ts", "TypeScript", 17, 0, 6, 23
"d:\typescript\learning\c5-ts-fp\src\Searches\BinarySearchList.ts", "TypeScript", 31, 2, 5, 38
"d:\typescript\learning\c5-ts-fp\src\Searches\BreadthFirstSearch.ts", "TypeScript", 20, 4, 6, 30
"d:\typescript\learning\c5-ts-fp\src\Searches\CompareBinaryTries.ts", "TypeScript", 16, 3, 5, 24
"d:\typescript\learning\c5-ts-fp\src\Searches\InOrderSearch.ts", "TypeScript", 13, 4, 6, 23
"d:\typescript\learning\c5-ts-fp\src\Searches\LinearSearchList.ts", "TypeScript", 20, 0, 3, 23
"d:\typescript\learning\c5-ts-fp\src\Searches\PostOrderSearch.ts", "TypeScript", 13, 4, 7, 24
"d:\typescript\learning\c5-ts-fp\src\Searches\PreOrderSearch.ts", "TypeScript", 13, 4, 5, 22
"d:\typescript\learning\c5-ts-fp\src\Searches\index.ts", "TypeScript", 16, 0, 2, 18
"d:\typescript\learning\c5-ts-fp\src\Sorters\BubbleSort.ts", "TypeScript", 56, 0, 3, 59
"d:\typescript\learning\c5-ts-fp\src\Sorters\QuickSort.ts", "TypeScript", 89, 0, 10, 99
"d:\typescript\learning\c5-ts-fp\src\Sorters\index.ts", "TypeScript", 3, 0, 2, 5
"d:\typescript\learning\c5-ts-fp\src\Stack.ts", "TypeScript", 20, 0, 7, 27
"d:\typescript\learning\c5-ts-fp\src\Structures\DoublyLinkedList.ts", "TypeScript", 127, 2, 34, 163
"d:\typescript\learning\c5-ts-fp\src\Structures\RingBuffer.ts", "TypeScript", 29, 1, 8, 38
"d:\typescript\learning\c5-ts-fp\src\Structures\index.ts", "TypeScript", 3, 0, 2, 5
"d:\typescript\learning\c5-ts-fp\src\Utils\addDays.ts", "TypeScript", 10, 0, 4, 14
"d:\typescript\learning\c5-ts-fp\src\Utils\append.ts", "TypeScript", 2, 0, 1, 3
"d:\typescript\learning\c5-ts-fp\src\Utils\date.ts", "TypeScript", 65, 0, 9, 74
"d:\typescript\learning\c5-ts-fp\src\Utils\format.ts", "TypeScript", 40, 1, 7, 48
"d:\typescript\learning\c5-ts-fp\src\Utils\index.ts", "TypeScript", 10, 0, 2, 12
"d:\typescript\learning\c5-ts-fp\src\Utils\isValid.ts", "TypeScript", 17, 0, 9, 26
"d:\typescript\learning\c5-ts-fp\src\Utils\pad.ts", "TypeScript", 21, 0, 4, 25
"d:\typescript\learning\c5-ts-fp\src\Utils\prop.ts", "TypeScript", 1, 0, 1, 2
"d:\typescript\learning\c5-ts-fp\src\Utils\swap.ts", "TypeScript", 6, 0, 1, 7
"d:\typescript\learning\c5-ts-fp\src\Utils\trace.ts", "TypeScript", 6, 0, 1, 7
"d:\typescript\learning\c5-ts-fp\src\compose.ts", "TypeScript", 4, 0, 1, 5
"d:\typescript\learning\c5-ts-fp\src\curry.ts", "TypeScript", 9, 0, 1, 10
"d:\typescript\learning\c5-ts-fp\src\index.ts", "TypeScript", 11, 0, 2, 13
"d:\typescript\learning\c5-ts-fp\src\sum.ts", "TypeScript", 8, 0, 2, 10
"d:\typescript\learning\c5-ts-fp\src\types.ts", "TypeScript", 18, 0, 5, 23
"Total", "-", 735, 25, 165, 925